9 13 4 0 8 11
*************
****      * *
**   ****** *
*  *        *
  ***********
*  *        *
**   ****** *
****      * *
*********** *
