9 13 4 0 0 9
********* ***
****      * *
**   ****** *
*  *        *
  ***********
*  *        *
**   ****** *
****      * *
*************
